urn:cite:botcar:sloane.1	urn:cite:botcar:species.Andropogontenuispatheus
urn:cite:botcar:sloane.10	urn:cite:botcar:species.Astragalusmichauxii
urn:cite:botcar:sloane.100	urn:cite:botcar:species.Scirpuscyperinus
urn:cite:botcar:sloane.101	urn:cite:botcar:species.Styraxamericanus
urn:cite:botcar:sloane.102	urn:cite:botcar:species.Sericocarpusasteroides
urn:cite:botcar:sloane.103	urn:cite:botcar:species.Fuirenabreviseta
urn:cite:botcar:sloane.104	urn:cite:botcar:species.Liatrissquarrosa
urn:cite:botcar:sloane.105	urn:cite:botcar:species.Caryatomentosa
urn:cite:botcar:sloane.106	urn:cite:botcar:species.Sporobolusindicus
urn:cite:botcar:sloane.107	urn:cite:botcar:species.Seymeriapectinata
urn:cite:botcar:sloane.108	urn:cite:botcar:species.Sennaoccidentalis
urn:cite:botcar:sloane.109	urn:cite:botcar:species.Cyrillaracemiflora
urn:cite:botcar:sloane.11	urn:cite:botcar:species.Juncusscirpoides
urn:cite:botcar:sloane.110	urn:cite:botcar:species.Chrysogonumvirginianum
urn:cite:botcar:sloane.111	urn:cite:botcar:species.Nyssaaquatica
urn:cite:botcar:sloane.112	urn:cite:botcar:species.Carexglaucescens
urn:cite:botcar:sloane.113	urn:cite:botcar:species.Litseaaestivalis
urn:cite:botcar:sloane.114	urn:cite:botcar:species.Smilaxauriculata
urn:cite:botcar:sloane.116	urn:cite:botcar:species.Astragalusmichauxii
urn:cite:botcar:sloane.117	urn:cite:botcar:species.Caryatomentosa
urn:cite:botcar:sloane.118	urn:cite:botcar:species.Maianthemumracemosum
urn:cite:botcar:sloane.119	urn:cite:botcar:species.Phegopterishexagonoptera
urn:cite:botcar:sloane.12	urn:cite:botcar:species.Pediomelumcanescens
urn:cite:botcar:sloane.120	urn:cite:botcar:species.Pteleatrifoliata
urn:cite:botcar:sloane.121	urn:cite:botcar:species.Polygalalutea
urn:cite:botcar:sloane.122	urn:cite:botcar:species.Nymphaeaodorata
urn:cite:botcar:sloane.123	urn:cite:botcar:species.Gaillardiaaestivalis
urn:cite:botcar:sloane.124	urn:cite:botcar:species.Gleditsiaaquatica
urn:cite:botcar:sloane.125	urn:cite:botcar:species.Sabatiastellaris
urn:cite:botcar:sloane.126	urn:cite:botcar:species.Collinsoniacanadensis
urn:cite:botcar:sloane.127	urn:cite:botcar:species.Tiliaamericana
urn:cite:botcar:sloane.128	urn:cite:botcar:species.Symphyotrichumdumosum
urn:cite:botcar:sloane.129	urn:cite:botcar:species.Solidagopetiolaris
urn:cite:botcar:sloane.13	urn:cite:botcar:species.Commelinaerecta
urn:cite:botcar:sloane.131	urn:cite:botcar:species.Persicariavirginiana
urn:cite:botcar:sloane.132	urn:cite:botcar:species.Violalanceolata
urn:cite:botcar:sloane.134	urn:cite:botcar:species.Heleniumflexuosum
urn:cite:botcar:sloane.135	urn:cite:botcar:species.Ampelopsisarborea
urn:cite:botcar:sloane.136	urn:cite:botcar:species.Trautvetteriacaroliniensis
urn:cite:botcar:sloane.137	urn:cite:botcar:species.Ulmusrubra
urn:cite:botcar:sloane.138	urn:cite:botcar:species.Angelicavenenosa
urn:cite:botcar:sloane.139	urn:cite:botcar:species.Cephalanthusoccidentalis
urn:cite:botcar:sloane.14	urn:cite:botcar:species.Perseapalustris
urn:cite:botcar:sloane.140	urn:cite:botcar:species.Chrysopsismariana
urn:cite:botcar:sloane.141	urn:cite:botcar:species.Lespedezahirta
urn:cite:botcar:sloane.142	urn:cite:botcar:species.Solidagosempervirens
urn:cite:botcar:sloane.143	urn:cite:botcar:species.Seymeriacassioides
urn:cite:botcar:sloane.144	urn:cite:botcar:species.Lysimachiaciliata
urn:cite:botcar:sloane.145	urn:cite:botcar:species.Baptisiaalbescens
urn:cite:botcar:sloane.146	urn:cite:botcar:species.Pycnanthemumflexuosum
urn:cite:botcar:sloane.147	urn:cite:botcar:species.Lysimachiafraseri
urn:cite:botcar:sloane.148	urn:cite:botcar:species.Agalinispurpurea
urn:cite:botcar:sloane.15	urn:cite:botcar:species.Hydrangeaarborescens
urn:cite:botcar:sloane.150	urn:cite:botcar:species.Cocculuscarolinus
urn:cite:botcar:sloane.151	urn:cite:botcar:species.Pontederiacordata
urn:cite:botcar:sloane.152	urn:cite:botcar:species.Oenotherafilipes
urn:cite:botcar:sloane.153	urn:cite:botcar:species.Polygalalutea
urn:cite:botcar:sloane.154	urn:cite:botcar:species.Vernoniagigantea
urn:cite:botcar:sloane.155	urn:cite:botcar:species.Daleapinnata
urn:cite:botcar:sloane.157	urn:cite:botcar:species.Baptisiabracteata
urn:cite:botcar:sloane.158	urn:cite:botcar:species.Eupatoriumcapillifolium
urn:cite:botcar:sloane.159	urn:cite:botcar:species.Apocynumcannabinum
urn:cite:botcar:sloane.16	urn:cite:botcar:species.Smilaxpumila
urn:cite:botcar:sloane.160	urn:cite:botcar:species.Silenevirginica
urn:cite:botcar:sloane.161	urn:cite:botcar:species.Polypremumprocumbens
urn:cite:botcar:sloane.162	urn:cite:botcar:species.Trichostemadichotomum
urn:cite:botcar:sloane.163	urn:cite:botcar:species.Rubuspensilvanicus
urn:cite:botcar:sloane.164	urn:cite:botcar:species.Cocculuscarolinus
urn:cite:botcar:sloane.165	urn:cite:botcar:species.Ceanothusamericanus
urn:cite:botcar:sloane.166	urn:cite:botcar:species.Brunnichiaovata
urn:cite:botcar:sloane.167	urn:cite:botcar:species.Helianthushirsutus
urn:cite:botcar:sloane.168	urn:cite:botcar:species.Rhynchosporafascicularis
urn:cite:botcar:sloane.169	urn:cite:botcar:species.Nyssaaquatica
urn:cite:botcar:sloane.17	urn:cite:botcar:species.Pycnanthemumflexuosum
urn:cite:botcar:sloane.170	urn:cite:botcar:species.Kalmialatifolia
urn:cite:botcar:sloane.171	urn:cite:botcar:species.Ludwigiapilosa
urn:cite:botcar:sloane.172	urn:cite:botcar:species.Populusheterophylla
urn:cite:botcar:sloane.173	urn:cite:botcar:species.Rudbeckiahirta
urn:cite:botcar:sloane.174	urn:cite:botcar:species.Pteleatrifoliata
urn:cite:botcar:sloane.175	urn:cite:botcar:species.Quercusvirginiana
urn:cite:botcar:sloane.176	urn:cite:botcar:species.Marshalliagraminifolia
urn:cite:botcar:sloane.177	urn:cite:botcar:species.Hypericumcrux
urn:cite:botcar:sloane.178	urn:cite:botcar:species.Pseudognaphaliumobtusifolium
urn:cite:botcar:sloane.179	urn:cite:botcar:species.Liatrissquarrulosa
urn:cite:botcar:sloane.18	urn:cite:botcar:species.Baptisiatinctoria
urn:cite:botcar:sloane.180	urn:cite:botcar:species.Caryatomentosa
urn:cite:botcar:sloane.181	urn:cite:botcar:species.Trilisapaniculata
urn:cite:botcar:sloane.182	urn:cite:botcar:species.Medeolavirginiana
urn:cite:botcar:sloane.183	urn:cite:botcar:species.Heliopsishelianthoides
urn:cite:botcar:sloane.184	urn:cite:botcar:species.Sidarhombifolia
urn:cite:botcar:sloane.185	urn:cite:botcar:species.Euthamiacaroliniana
urn:cite:botcar:sloane.186	urn:cite:botcar:species.Solidagoodora
urn:cite:botcar:sloane.187	urn:cite:botcar:species.Seymeriacassioides
urn:cite:botcar:sloane.188	urn:cite:botcar:species.Amorphaglabra
urn:cite:botcar:sloane.189	urn:cite:botcar:species.Lyonialucida
urn:cite:botcar:sloane.19	urn:cite:botcar:species.Liquidambarstyraciflua
urn:cite:botcar:sloane.190	urn:cite:botcar:species.Bigelowianudata
urn:cite:botcar:sloane.191	urn:cite:botcar:species.Glandulariacanadensis
urn:cite:botcar:sloane.192	urn:cite:botcar:species.Commelinaerecta
urn:cite:botcar:sloane.193	urn:cite:botcar:species.Orbexilumpedunculatum
urn:cite:botcar:sloane.194	urn:cite:botcar:species.Amorphaherbacea
urn:cite:botcar:sloane.195	urn:cite:botcar:species.Phloxamoena
urn:cite:botcar:sloane.196	urn:cite:botcar:species.Actaearacemosa
urn:cite:botcar:sloane.197	urn:cite:botcar:species.Hypericumwalteri
urn:cite:botcar:sloane.198	urn:cite:botcar:species.Cornusasperifolia
urn:cite:botcar:sloane.199	urn:cite:botcar:species.Prenanthesserpentaria
urn:cite:botcar:sloane.2	urn:cite:botcar:species.Diospyrosvirginiana
urn:cite:botcar:sloane.20	urn:cite:botcar:species.Berlandierapumila
urn:cite:botcar:sloane.200	urn:cite:botcar:species.Polygalalutea
urn:cite:botcar:sloane.201	urn:cite:botcar:species.Hylodesmumglutinosum
urn:cite:botcar:sloane.202	urn:cite:botcar:species.Baptisiaperfoliata
urn:cite:botcar:sloane.203	urn:cite:botcar:species.Laporteacanadensis
urn:cite:botcar:sloane.204	urn:cite:botcar:species.Eupatoriumserotinum
urn:cite:botcar:sloane.205	urn:cite:botcar:species.Cteniumaromaticum
urn:cite:botcar:sloane.206	urn:cite:botcar:species.Lespedezahirta
urn:cite:botcar:sloane.207	urn:cite:botcar:species.Stachysindet
urn:cite:botcar:sloane.208	urn:cite:botcar:species.Bacopamonnieri
urn:cite:botcar:sloane.209	urn:cite:botcar:species.Monardapunctata
urn:cite:botcar:sloane.21	urn:cite:botcar:species.Castaneapumila
urn:cite:botcar:sloane.210	urn:cite:botcar:species.Liatriselegans
urn:cite:botcar:sloane.211	urn:cite:botcar:species.Lobeliapuberula
urn:cite:botcar:sloane.212	urn:cite:botcar:species.Triantharacemosa
urn:cite:botcar:sloane.213	urn:cite:botcar:species.Liatrisspicata
urn:cite:botcar:sloane.214	urn:cite:botcar:species.Berchemiascandens
urn:cite:botcar:sloane.215	urn:cite:botcar:species.Helianthusangustifolius
urn:cite:botcar:sloane.216	urn:cite:botcar:species.Liatriselegans
urn:cite:botcar:sloane.217	urn:cite:botcar:species.Trilisapaniculata
urn:cite:botcar:sloane.218	urn:cite:botcar:species.Uniolapaniculata
urn:cite:botcar:sloane.22	urn:cite:botcar:species.Eriocaulondecangulare
urn:cite:botcar:sloane.220	urn:cite:botcar:species.Liatriselegans
urn:cite:botcar:sloane.221	urn:cite:botcar:species.Clematisviorna
urn:cite:botcar:sloane.222	urn:cite:botcar:species.Asclepiashumistrata
urn:cite:botcar:sloane.223	urn:cite:botcar:species.Phaseoluspolystachios
urn:cite:botcar:sloane.224	urn:cite:botcar:species.Lycopodiellaalopecuroides
urn:cite:botcar:sloane.225	urn:cite:botcar:species.Rhynchosiatomentosa
urn:cite:botcar:sloane.226	urn:cite:botcar:species.Vitisaestivalis
urn:cite:botcar:sloane.227	urn:cite:botcar:species.Diospyrosvirginiana
urn:cite:botcar:sloane.228	urn:cite:botcar:species.Cnidoscolusstimulosus
urn:cite:botcar:sloane.229	urn:cite:botcar:species.Woodwardiaareolata
urn:cite:botcar:sloane.23	urn:cite:botcar:species.Coreopsismajor
urn:cite:botcar:sloane.230	urn:cite:botcar:species.Pediculariscanadensis
urn:cite:botcar:sloane.231	urn:cite:botcar:species.Cornusflorida
urn:cite:botcar:sloane.232	urn:cite:botcar:species.Vacciniumstamineum
urn:cite:botcar:sloane.233	urn:cite:botcar:species.Quercusalba
urn:cite:botcar:sloane.234	urn:cite:botcar:species.Taxodiumascendens
urn:cite:botcar:sloane.235	urn:cite:botcar:species.Salvialyrata
urn:cite:botcar:sloane.236	urn:cite:botcar:species.Osmundaregalis
urn:cite:botcar:sloane.237	urn:cite:botcar:species.Cocculuscarolinus
urn:cite:botcar:sloane.238	urn:cite:botcar:species.Hamamelisvirginiana
urn:cite:botcar:sloane.239	urn:cite:botcar:species.Quercusmarilandica
urn:cite:botcar:sloane.24	urn:cite:botcar:species.Eryngiumintegrifolium
urn:cite:botcar:sloane.240	urn:cite:botcar:species.Setariaparviflora
urn:cite:botcar:sloane.241	urn:cite:botcar:species.Carexglaucescens
urn:cite:botcar:sloane.242	urn:cite:botcar:species.Stillingiasylvatica
urn:cite:botcar:sloane.243	urn:cite:botcar:species.Liquidambarstyraciflua
urn:cite:botcar:sloane.244	urn:cite:botcar:species.Sennaoccidentalis
urn:cite:botcar:sloane.245	urn:cite:botcar:species.Metopiumtoxiferum
urn:cite:botcar:sloane.246	urn:cite:botcar:species.Alliumcuthbertii
urn:cite:botcar:sloane.248	urn:cite:botcar:species.Setariaparviflora
urn:cite:botcar:sloane.249	urn:cite:botcar:species.Pycnanthemumflexuosum
urn:cite:botcar:sloane.25	urn:cite:botcar:species.Heleniumflexuosum
urn:cite:botcar:sloane.250	urn:cite:botcar:species.Chamaesycesp
urn:cite:botcar:sloane.251	urn:cite:botcar:species.Physalisangulata
urn:cite:botcar:sloane.252	urn:cite:botcar:species.Chamaesycesp
urn:cite:botcar:sloane.253	urn:cite:botcar:species.Sarraceniaminor
urn:cite:botcar:sloane.255	urn:cite:botcar:species.Melanthiumhybridum
urn:cite:botcar:sloane.256	urn:cite:botcar:species.Amsoniatabernaemontana
urn:cite:botcar:sloane.257	urn:cite:botcar:species.Eutrochiumdubium
urn:cite:botcar:sloane.258	urn:cite:botcar:species.Rhexiaalifanus
urn:cite:botcar:sloane.259	urn:cite:botcar:species.Clethratomentosa
urn:cite:botcar:sloane.26	urn:cite:botcar:species.Physostegiapurpurea
urn:cite:botcar:sloane.260	urn:cite:botcar:species.Fraxinuspennsylvanica
urn:cite:botcar:sloane.261	urn:cite:botcar:species.Prunuscaroliniana
urn:cite:botcar:sloane.262	urn:cite:botcar:species.Gordonialasianthus
urn:cite:botcar:sloane.263	urn:cite:botcar:species.Spigeliamarilandica
urn:cite:botcar:sloane.264	urn:cite:botcar:species.Eupatoriumserotinum
urn:cite:botcar:sloane.265	urn:cite:botcar:species.Ceanothusamericanus
urn:cite:botcar:sloane.266	urn:cite:botcar:species.Asclepiasverticillata
urn:cite:botcar:sloane.267	urn:cite:botcar:species.Marshalliaobovata
urn:cite:botcar:sloane.268	urn:cite:botcar:species.Quercuslaevis
urn:cite:botcar:sloane.269	urn:cite:botcar:species.Epifagusvirginiana
urn:cite:botcar:sloane.27	urn:cite:botcar:species.Lactucasp
urn:cite:botcar:sloane.270	urn:cite:botcar:species.Amianthiummuscitoxicum
urn:cite:botcar:sloane.271	urn:cite:botcar:species.Kalmialatifolia
urn:cite:botcar:sloane.272	urn:cite:botcar:species.Erigeronstrigosus
urn:cite:botcar:sloane.274	urn:cite:botcar:species.Phleumarenarium
urn:cite:botcar:sloane.275	urn:cite:botcar:species.Oenotherafilipes
urn:cite:botcar:sloane.276	urn:cite:botcar:species.Geumcanadense
urn:cite:botcar:sloane.277	urn:cite:botcar:species.Habenariarepens
urn:cite:botcar:sloane.278	urn:cite:botcar:species.Leucothoefontanesiana
urn:cite:botcar:sloane.279	urn:cite:botcar:species.Saccharumgiganteum
urn:cite:botcar:sloane.28	urn:cite:botcar:species.Tephrosiaspicata
urn:cite:botcar:sloane.280	urn:cite:botcar:species.Indigoferatinctoria
urn:cite:botcar:sloane.281	urn:cite:botcar:species.Calystegiacatesbeiana
urn:cite:botcar:sloane.282	urn:cite:botcar:species.Eriocaulondecangulare
urn:cite:botcar:sloane.283	urn:cite:botcar:species.Melanthiumhybridum
urn:cite:botcar:sloane.284	urn:cite:botcar:species.Cicutamaculata
urn:cite:botcar:sloane.285	urn:cite:botcar:species.Ostryavirginiana
urn:cite:botcar:sloane.286	urn:cite:botcar:species.Asclepiashumistrata
urn:cite:botcar:sloane.287	urn:cite:botcar:species.Asclepiasamplexicaulis
urn:cite:botcar:sloane.288	urn:cite:botcar:species.Thaspiumtrifoliatum
urn:cite:botcar:sloane.289	urn:cite:botcar:species.Aletrisaurea
urn:cite:botcar:sloane.29	urn:cite:botcar:species.Clematiscrispa
urn:cite:botcar:sloane.290	urn:cite:botcar:species.Ampelastercarolinianus
urn:cite:botcar:sloane.291	urn:cite:botcar:species.Symphyotrichumconcolor
urn:cite:botcar:sloane.292	urn:cite:botcar:species.Cerciscanadensis
urn:cite:botcar:sloane.294	urn:cite:botcar:species.Polygalapolygama
urn:cite:botcar:sloane.295	urn:cite:botcar:species.Tragiaurticifolia
urn:cite:botcar:sloane.296	urn:cite:botcar:species.Perseaborbonia
urn:cite:botcar:sloane.297	urn:cite:botcar:species.Nolinageorgiana
urn:cite:botcar:sloane.298	urn:cite:botcar:species.Erigeronquercifolius
urn:cite:botcar:sloane.299	urn:cite:botcar:species.Chamaecristanictitans
urn:cite:botcar:sloane.30	urn:cite:botcar:species.Ludwigiavirgata
urn:cite:botcar:sloane.300	urn:cite:botcar:species.Ipomopsisrubra
urn:cite:botcar:sloane.301	urn:cite:botcar:species.Ludwigiapilosa
urn:cite:botcar:sloane.302	urn:cite:botcar:species.Populusdeltoides
urn:cite:botcar:sloane.303	urn:cite:botcar:species.Phalariscaroliniana
urn:cite:botcar:sloane.305	urn:cite:botcar:species.Ilexcassine
urn:cite:botcar:sloane.306	urn:cite:botcar:species.Podophyllumpeltatum
urn:cite:botcar:sloane.307	urn:cite:botcar:species.Eupatoriumpurpureum
urn:cite:botcar:sloane.308	urn:cite:botcar:species.Morusrubra
urn:cite:botcar:sloane.309	urn:cite:botcar:species.Oxydendrumarboreum
urn:cite:botcar:sloane.310	urn:cite:botcar:species.Collinsoniatuberosa
urn:cite:botcar:sloane.311	urn:cite:botcar:species.Orbexilumpedunculatum
urn:cite:botcar:sloane.312	urn:cite:botcar:species.Carexglaucescens
urn:cite:botcar:sloane.313	urn:cite:botcar:species.Thaspiumbarbinode
urn:cite:botcar:sloane.315	urn:cite:botcar:species.Lycopusvirginicus
urn:cite:botcar:sloane.316	urn:cite:botcar:species.Taxodiumdistichum
urn:cite:botcar:sloane.317	urn:cite:botcar:species.Eupatoriumleucolepis
urn:cite:botcar:sloane.318	urn:cite:botcar:species.Pycnanthemumpycnanthemoides
urn:cite:botcar:sloane.319	urn:cite:botcar:species.Lithospermumcaroliniense
urn:cite:botcar:sloane.32	urn:cite:botcar:species.Endodecaserpentaria
urn:cite:botcar:sloane.320	urn:cite:botcar:species.Tephrosiavirginiana
urn:cite:botcar:sloane.321	urn:cite:botcar:species.Lupinusvillosus
urn:cite:botcar:sloane.322	urn:cite:botcar:species.Trilliummaculatum
urn:cite:botcar:sloane.323	urn:cite:botcar:species.Athyriumasplenioides
urn:cite:botcar:sloane.324	urn:cite:botcar:species.Asclepiasrubra
urn:cite:botcar:sloane.325	urn:cite:botcar:species.Liatrissecunda
urn:cite:botcar:sloane.326	urn:cite:botcar:species.Impatienscapensis
urn:cite:botcar:sloane.327	urn:cite:botcar:species.Lobeliaelongata
urn:cite:botcar:sloane.328	urn:cite:botcar:species.Mimosaquadrivalvis
urn:cite:botcar:sloane.329	urn:cite:botcar:species.Pediomelumcanescens
urn:cite:botcar:sloane.33	urn:cite:botcar:species.Ilexcassine
urn:cite:botcar:sloane.330	urn:cite:botcar:species.Paspalumfloridanum
urn:cite:botcar:sloane.331	urn:cite:botcar:species.Asclepiastuberosa
urn:cite:botcar:sloane.332	urn:cite:botcar:species.Podostemumceratophyllum
urn:cite:botcar:sloane.333	urn:cite:botcar:species.Pityopsisgraminifolia
urn:cite:botcar:sloane.334	urn:cite:botcar:species.Rhynchosporaglomerata
urn:cite:botcar:sloane.335	urn:cite:botcar:species.Baptisiatinctoria
urn:cite:botcar:sloane.336	urn:cite:botcar:species.Chasmanthiumlatifolium
urn:cite:botcar:sloane.337	urn:cite:botcar:species.Ptilimniumcapillaceum
urn:cite:botcar:sloane.338	urn:cite:botcar:species.Eupatoriumcapillifolium
urn:cite:botcar:sloane.339	urn:cite:botcar:species.Polygalaramosa
urn:cite:botcar:sloane.34	urn:cite:botcar:species.Osmanthusamericanus
urn:cite:botcar:sloane.340	urn:cite:botcar:species.Setariamagna
urn:cite:botcar:sloane.341	urn:cite:botcar:species.Melothriapendula
urn:cite:botcar:sloane.342	urn:cite:botcar:species.Quercusphellos
urn:cite:botcar:sloane.343	urn:cite:botcar:species.Osmorhizalongistylis
urn:cite:botcar:sloane.344	urn:cite:botcar:species.Plucheafoetida
urn:cite:botcar:sloane.345	urn:cite:botcar:species.Acerrubrum
urn:cite:botcar:sloane.346	urn:cite:botcar:species.Coreopsisdelphiniifolia
urn:cite:botcar:sloane.347	urn:cite:botcar:species.Impatienscapensis
urn:cite:botcar:sloane.348	urn:cite:botcar:species.Amianthiummuscitoxicum
urn:cite:botcar:sloane.349	urn:cite:botcar:species.Ceanothusamericanus
urn:cite:botcar:sloane.35	urn:cite:botcar:species.Monardapunctata
urn:cite:botcar:sloane.350	urn:cite:botcar:species.Eriocaulondecangulare
urn:cite:botcar:sloane.351	urn:cite:botcar:species.Stillingiasylvatica
urn:cite:botcar:sloane.352	urn:cite:botcar:species.Sidarhombifolia
urn:cite:botcar:sloane.353	urn:cite:botcar:species.Cyperusechinatus
urn:cite:botcar:sloane.354	urn:cite:botcar:species.Geumcanadense
urn:cite:botcar:sloane.355	urn:cite:botcar:species.Gentianacatesbaei
urn:cite:botcar:sloane.356	urn:cite:botcar:species.Coreopsislanceolata
urn:cite:botcar:sloane.358	urn:cite:botcar:species.Glandulariacanadensis
urn:cite:botcar:sloane.359	urn:cite:botcar:species.Pediculariscanadensis
urn:cite:botcar:sloane.36	urn:cite:botcar:species.Setariaparviflora
urn:cite:botcar:sloane.361	urn:cite:botcar:species.Fuirenasquarrosa
urn:cite:botcar:sloane.362	urn:cite:botcar:species.Kosteletzkyapentacarpos
urn:cite:botcar:sloane.363	urn:cite:botcar:species.Asarumcanadense
urn:cite:botcar:sloane.364	urn:cite:botcar:species.Galactiavolubilis
urn:cite:botcar:sloane.366	urn:cite:botcar:species.Lespedezavirginica
urn:cite:botcar:sloane.367	urn:cite:botcar:species.Carphephoruscarnosus
urn:cite:botcar:sloane.368	urn:cite:botcar:species.Sericocarpustortifolius
urn:cite:botcar:sloane.369	urn:cite:botcar:species.Ceratiolaericoides
urn:cite:botcar:sloane.37	urn:cite:botcar:species.Dyschoristeoblongifolia
urn:cite:botcar:sloane.370	urn:cite:botcar:species.Liatrisspicata
urn:cite:botcar:sloane.371	urn:cite:botcar:species.Polygalapolygama
urn:cite:botcar:sloane.372	urn:cite:botcar:species.Acersaccharinum
urn:cite:botcar:sloane.373	urn:cite:botcar:species.Sabatiadifformis
urn:cite:botcar:sloane.375	urn:cite:botcar:species.Teucriumcanadense
urn:cite:botcar:sloane.376	urn:cite:botcar:species.Iteavirginica
urn:cite:botcar:sloane.377	urn:cite:botcar:species.Polystichumacrostichoides
urn:cite:botcar:sloane.378	urn:cite:botcar:species.Aspleniumtrichomanes
urn:cite:botcar:sloane.379	urn:cite:botcar:species.Liatrissquarrulosa
urn:cite:botcar:sloane.38	urn:cite:botcar:species.Tephrosiaspicata
urn:cite:botcar:sloane.380	urn:cite:botcar:species.Ipomoeacoccinea
urn:cite:botcar:sloane.381	urn:cite:botcar:species.Prenanthesautumnalis
urn:cite:botcar:sloane.382	urn:cite:botcar:species.Eleusineindica
urn:cite:botcar:sloane.383	urn:cite:botcar:species.Quercusincana
urn:cite:botcar:sloane.384	urn:cite:botcar:species.Oxydendrumarboreum
urn:cite:botcar:sloane.385	urn:cite:botcar:species.Chrysopsismariana
urn:cite:botcar:sloane.387	urn:cite:botcar:species.Bidensfrondosa
urn:cite:botcar:sloane.388	urn:cite:botcar:species.Sabatiaangularis
urn:cite:botcar:sloane.389	urn:cite:botcar:species.Liriodendrontulipifera
urn:cite:botcar:sloane.39	urn:cite:botcar:species.Baptisiaalbescens
urn:cite:botcar:sloane.390	urn:cite:botcar:species.Arnoglossumatriplicifolium
urn:cite:botcar:sloane.391	urn:cite:botcar:species.Quercusmichauxii
urn:cite:botcar:sloane.392	urn:cite:botcar:species.Pediculariscanadensis
urn:cite:botcar:sloane.393	urn:cite:botcar:species.Solidagofistulosa
urn:cite:botcar:sloane.394	urn:cite:botcar:species.Chamaesycesp
urn:cite:botcar:sloane.395	urn:cite:botcar:species.Silphiumasteriscus
urn:cite:botcar:sloane.396	urn:cite:botcar:species.Saururuscernuus
urn:cite:botcar:sloane.397	urn:cite:botcar:species.Rhexiavirginica
urn:cite:botcar:sloane.398	urn:cite:botcar:species.Smallanthusuvedalius
urn:cite:botcar:sloane.399	urn:cite:botcar:species.Eupatoriumcompositifolium
urn:cite:botcar:sloane.4	urn:cite:botcar:species.Quercuslaevis
urn:cite:botcar:sloane.40	urn:cite:botcar:species.Thalictrumrevolutum
urn:cite:botcar:sloane.400	urn:cite:botcar:species.Sporobolusindicus
urn:cite:botcar:sloane.401	urn:cite:botcar:species.Zizaniaaquatica
urn:cite:botcar:sloane.402	urn:cite:botcar:species.Prunusumbellata
urn:cite:botcar:sloane.403	urn:cite:botcar:species.Cyperusechinatus
urn:cite:botcar:sloane.404	urn:cite:botcar:species.Euthamiacaroliniana
urn:cite:botcar:sloane.406	urn:cite:botcar:species.Pontederiacordata
urn:cite:botcar:sloane.407	urn:cite:botcar:species.Orbexilumpedunculatum
urn:cite:botcar:sloane.408	urn:cite:botcar:species.Asclepiastuberosa
urn:cite:botcar:sloane.409	urn:cite:botcar:species.Gamochaetaantillana
urn:cite:botcar:sloane.41	urn:cite:botcar:species.Toxicodendronvernix
urn:cite:botcar:sloane.410	urn:cite:botcar:species.Selaginellaapoda
urn:cite:botcar:sloane.411	urn:cite:botcar:species.Monardapunctata
urn:cite:botcar:sloane.412	urn:cite:botcar:species.Cornusflorida
urn:cite:botcar:sloane.413	urn:cite:botcar:species.Hylodesmumglutinosum
urn:cite:botcar:sloane.414	urn:cite:botcar:species.Osmorhizalongistylis
urn:cite:botcar:sloane.415	urn:cite:botcar:species.Pteleatrifoliata
urn:cite:botcar:sloane.416	urn:cite:botcar:species.Symphyotrichumconcolor
urn:cite:botcar:sloane.417	urn:cite:botcar:species.Iteavirginica
urn:cite:botcar:sloane.418	urn:cite:botcar:species.Xyrisambigua
urn:cite:botcar:sloane.419	urn:cite:botcar:species.Clethratomentosa
urn:cite:botcar:sloane.42	urn:cite:botcar:species.Prunellavulgaris
urn:cite:botcar:sloane.420	urn:cite:botcar:species.Quercusnigra
urn:cite:botcar:sloane.421	urn:cite:botcar:species.Platanusoccidentalis
urn:cite:botcar:sloane.422	urn:cite:botcar:species.Acernegundo
urn:cite:botcar:sloane.423	urn:cite:botcar:species.Gaillardiaaestivalis
urn:cite:botcar:sloane.424	urn:cite:botcar:species.Baptisiaperfoliata
urn:cite:botcar:sloane.425	urn:cite:botcar:species.Vernoniaacaulis
urn:cite:botcar:sloane.426	urn:cite:botcar:species.Polygonatumbiflorum
urn:cite:botcar:sloane.427	urn:cite:botcar:species.Ampelastercarolinianus
urn:cite:botcar:sloane.428	urn:cite:botcar:species.Eupatoriumperfoliatum
urn:cite:botcar:sloane.429	urn:cite:botcar:species.Vernoniaangustifolia
urn:cite:botcar:sloane.43	urn:cite:botcar:species.Salvialyrata
urn:cite:botcar:sloane.430	urn:cite:botcar:species.Delphiniumcarolinianum
urn:cite:botcar:sloane.431	urn:cite:botcar:species.Catalpabignonioides
urn:cite:botcar:sloane.432	urn:cite:botcar:species.Violasororia
urn:cite:botcar:sloane.44	urn:cite:botcar:species.Liatrisspicata
urn:cite:botcar:sloane.45	urn:cite:botcar:species.Onosmodiumvirginianum
urn:cite:botcar:sloane.46	urn:cite:botcar:species.Platantheraciliaris
urn:cite:botcar:sloane.47	urn:cite:botcar:species.Calycanthusfloridus
urn:cite:botcar:sloane.48	urn:cite:botcar:species.Liliumcatesbaei
urn:cite:botcar:sloane.49	urn:cite:botcar:species.Taxodiumascendens
urn:cite:botcar:sloane.5	urn:cite:botcar:species.Eupatoriumleucolepis
urn:cite:botcar:sloane.50	urn:cite:botcar:species.Hibiscusmoscheutos
urn:cite:botcar:sloane.53	urn:cite:botcar:species.Polygalamariana
urn:cite:botcar:sloane.54	urn:cite:botcar:species.Nasturtiumofficinale
urn:cite:botcar:sloane.55	urn:cite:botcar:species.Quercusphellos
urn:cite:botcar:sloane.56	urn:cite:botcar:species.Coreopsislanceolata
urn:cite:botcar:sloane.57	urn:cite:botcar:species.Cyperusvirens
urn:cite:botcar:sloane.58	urn:cite:botcar:species.Chrysopsisgossypina
urn:cite:botcar:sloane.59	urn:cite:botcar:species.Polytrichumcommune
urn:cite:botcar:sloane.6	urn:cite:botcar:species.Polygalagrandiflora
urn:cite:botcar:sloane.60	urn:cite:botcar:species.Coelorachisrugosa
urn:cite:botcar:sloane.62	urn:cite:botcar:species.Carpinuscaroliniana
urn:cite:botcar:sloane.63	urn:cite:botcar:species.Philadelphusinodorus
urn:cite:botcar:sloane.64	urn:cite:botcar:species.Chrysopsismariana
urn:cite:botcar:sloane.65	urn:cite:botcar:species.Hydrangearadiata
urn:cite:botcar:sloane.66	urn:cite:botcar:species.Mateleacarolinensis
urn:cite:botcar:sloane.67	urn:cite:botcar:species.Eriogonumtomentosum
urn:cite:botcar:sloane.68	urn:cite:botcar:species.Nyssasylvatica
urn:cite:botcar:sloane.69	urn:cite:botcar:species.Ilexambigua
urn:cite:botcar:sloane.7	urn:cite:botcar:species.Trilliumcatesbaei
urn:cite:botcar:sloane.70	urn:cite:botcar:species.Asclepiasobovata
urn:cite:botcar:sloane.71	urn:cite:botcar:species.Lobeliaelongata
urn:cite:botcar:sloane.72	urn:cite:botcar:species.Sarraceniarubra
urn:cite:botcar:sloane.73	urn:cite:botcar:species.Menispermumcanadense
urn:cite:botcar:sloane.74	urn:cite:botcar:species.Polygalacruciata
urn:cite:botcar:sloane.75	urn:cite:botcar:species.Sarraceniaminor
urn:cite:botcar:sloane.76	urn:cite:botcar:species.Nymphaeaodorata
urn:cite:botcar:sloane.77	urn:cite:botcar:species.Platantheraintegra
urn:cite:botcar:sloane.79	urn:cite:botcar:species.Symphyotrichumdumosum
urn:cite:botcar:sloane.8	urn:cite:botcar:species.Quercusmichauxii
urn:cite:botcar:sloane.80	urn:cite:botcar:species.Catalpabignonioides
urn:cite:botcar:sloane.81	urn:cite:botcar:species.Dioscoreavillosa
urn:cite:botcar:sloane.82	urn:cite:botcar:species.Triodanisperfoliata
urn:cite:botcar:sloane.83	urn:cite:botcar:species.Chaptaliatomentosa
urn:cite:botcar:sloane.84	urn:cite:botcar:species.Cyrillaracemiflora
urn:cite:botcar:sloane.85	urn:cite:botcar:species.Scutellariaelliptica
urn:cite:botcar:sloane.86	urn:cite:botcar:species.Lupinusdiffusus
urn:cite:botcar:sloane.87	urn:cite:botcar:species.Asclepiasviridiflora
urn:cite:botcar:sloane.88	urn:cite:botcar:species.Apiosamericana
urn:cite:botcar:sloane.89	urn:cite:botcar:species.Sarraceniaminor
urn:cite:botcar:sloane.9	urn:cite:botcar:species.Phylanodiflora
urn:cite:botcar:sloane.90	urn:cite:botcar:species.Paspalumfloridanum
urn:cite:botcar:sloane.91	urn:cite:botcar:species.Rhynchosporacolorata
urn:cite:botcar:sloane.92	urn:cite:botcar:species.Hyptisalata
urn:cite:botcar:sloane.93	urn:cite:botcar:species.Coreopsismajor
urn:cite:botcar:sloane.94	urn:cite:botcar:species.Rhexiaalifanus
urn:cite:botcar:sloane.95	urn:cite:botcar:species.Gordonialasianthus
urn:cite:botcar:sloane.96	urn:cite:botcar:species.Toxicodendronradicans
urn:cite:botcar:sloane.97	urn:cite:botcar:species.Lachnanthescaroliniana
urn:cite:botcar:sloane.98	urn:cite:botcar:species.Lysimachiaquadrifolia
urn:cite:botcar:sloane.99	urn:cite:botcar:species.Polystichumacrostichoides
